HP:0000005	HP:0000001
HP:0000118	HP:0000001
HP:0012823	HP:0000001
HP:0040006	HP:0000001
HP:0040279	HP:0000001
